11111111111111111111111
11111111110P01111111111
11111111110010111101111
111111111C0011111111111
111000000000C1111111111
10101010101000000000001
11010101010100000000001
110011111111000011110C1
11111111111111100000001
11111111111111100111111
11111111111111110E11111
11111111111111111111111
