111111111111111
1P     1      1
111 111 11111 1
1   1   1   1 1
1 111 111 1 1 1
1 1       1 1 1
1 1 11111 1 1 1
1 1 1   1 1 1 1
1 1 1 1 1 1 1 1
1 1 1 1 1 1 1 1
1 1C1 1 1 1C1 1
1   1   1   1 1
111 111 111 111
1C          1C1
11111111111E111
