1111111111111111111111
10000P0000111000000001
1CCCCC0C0C011000000001
11111101111C1000000001
1111110000101000000001
10000CC0C1000000000001
10011C1000001000000001
1CCC111110111000000001
1000000000001000000001
1CCC000111111000000001
1ECC1CC111111000000001
1100111111111000000001
1CCCCCCCCCCC1000000001
1CCCCCCCCCCC1000000001
1CCCCCCCCCCC1000000001
1CCCCCCCCCCC1000000001
1CCCCCCCCCCC100000C001
1111111111111111111111
