111111
10C0P1
101C11
1E00C1
111111
