1111111
100C001
1011111
10P0001
11111E1
1000001
1111111
