11111
10CP1
10101
1E001
11111
